uld
0000d0000
000000000
000000000
000vvv000
d00vvv00d
000vvv000
000000000
000000000
0000d0000