uld
vvvvvvvvvvv
v0000d0000v
v000000000v
v000000000v
v000vvv000v
vd00vvv00dv
v000vvv000v
v000000000v
v000000000v
v0000d0000v
vvvvvvvvvvv